0000000000
0X000000X0
00X0000X00
00X0000X00
0000000000
00XXXXXX00
0000000000
00X0000X00
00X0000X00
0X000000X0