0000000000
XX000000XX
000XXXX000
X00000000X
00X0000X00
00XXXXXX00
0000000000
0XXX00XXX0
0000000000
0000000000